1111111111111
1101000000011
11000111110C1
1P0011E000011
1111111111111